w                              w
w                              w
w                              w
w                              w
w                              w
w                              w
w                              w
w                              w
w                              w
w                              w
w                              w
w                   e          w
w                   www        w
w                        w     w
w                       ww     t
w s       e     w     wwww     t
w  w      n    www             t
wwwwwww wwwwwwwwwwww  wwwwww  ww
